........
........
.###....
#..#....
#..#....
.###..##
....##..
...#....
.#...##.
....#..#
....#..#
.....##.
........
........
........
........
