........
........
........
........
........
........
........
........
........
........
...##...
...##...
...##...
...#....
........
........
