........
........
..####..
.##..##.
.##...#.
..#..##.
..####..
.##..##.
.#....#.
.#....#.
.##...#.
..####..
........
........
........
........
