........
........
........
........
.#####..
....##..
....#...
...#....
..##....
.##.....
.#......
######..
........
........
........
........
