........
........
...##...
..####..
..#..##.
.#....##
........
........
........
........
........
........
........
........
........
........
