........
....###.
....#...
....#...
....#...
....#...
...##...
..##....
...##...
....#...
....#...
....#...
....#...
....###.
........
........
