........
........
.##...#.
.##...#.
.###..#.
.#.#..#.
.#.##.#.
.#..#.#.
.#..#.#.
.#...##.
.#...##.
.#....#.
........
........
........
........
