........
........
.#......
.##.....
..#.....
..##....
...#....
...#....
....#...
....#...
.....#..
.....#..
.....##.
......#.
........
........
