........
........
.#....##
.#....##
.#....#.
.##...#.
..#..##.
..#..#..
..##.#..
...#.#..
...##...
...##...
........
........
........
........
