........
........
........
........
.#......
.###....
....###.
......##
....###.
.###....
.#......
........
........
........
........
........
