........
........
...###..
..#..##.
.##...#.
.#....#.
.#....#.
.#..#.#.
.#....#.
.##...#.
..#..##.
...###..
........
........
........
........
