........
........
........
........
.####...
.#...#..
.#......
.###....
...###..
.....#..
....##..
.####...
........
........
........
........
