........
........
........
........
..####..
.....##.
......#.
..#####.
.##...#.
.#....#.
.##..##.
..###.#.
........
........
........
........
