........
........
...##...
...###..
...#.#..
..##.#..
..#..#..
..#...#.
.######.
.#....#.
.#....##
##.....#
........
........
........
........
