........
###.....
..#.....
..#.....
..#.....
..#.....
..#.....
..#.....
..#.....
..#.....
..##....
...###..
........
........
........
........
