........
.#......
.#......
.#......
.#...#..
.#..#...
.#.#....
.###....
.#.##...
.#..#...
.#...#..
.#...##.
........
........
........
........
