........
........
#####...
##...#..
##...#..
##...#..
#####...
##...#..
##...##.
##...##.
##...#..
#####...
........
........
........
........
