........
........
........
........
.#....##
.##...#.
..#...#.
..#..##.
..##.#..
...#.#..
...##...
....#...
...##...
...#....
.###....
........
