........
........
........
........
.#....##
.#....#.
..#...#.
..#..##.
..#..#..
...#.#..
...###..
...##...
........
........
........
........
