........
........
........
........
.###.##.
.#.##.##
.#..#..#
.#..#..#
.#..#..#
.#..#..#
.#..#..#
.#..#..#
........
........
........
........
