........
........
...####.
..##....
.##.....
.##.....
.#......
.#......
.##.....
.##.....
..##....
...####.
........
........
........
........
