........
........
######..
##......
##......
##......
######..
##......
##......
##......
##......
#######.
........
........
........
........
