########################################
#..................#..................##
#..................#..................##
#..................+..................##
#..................#..................##
#..................#..................##
#..................#..................##
#########+##################+###########
#..................#..................##
#..................#..................##
#..................+..................##
#..................#..........>.......##
#..................#..................##
#..................#..................##
########################################
########################################
