........
........
..####..
..#..##.
.##...#.
.#....##
.#....##
.#....##
.#....##
.##...#.
..#..##.
..####..
........
........
........
........
