####################
#                  #
#  PAL BRAIN DEMO  #
#                  #
#      . . . .     #
#      . . . .     #
#                  #
#                  #
#                  #
####################
