........
........
...###..
..#...#.
.##.....
.#......
.#.###..
.##...#.
.#....#.
.#....#.
..#...#.
...###..
........
........
........
........
