........
....#...
...#....
...#....
..##....
..#.....
..#.....
..#.....
..#.....
..##....
...#....
...#....
....#...
........
........
........
