........
........
.#....##
.#...##.
.#..##..
.#.##...
.####...
.##.#...
.#..##..
.#...##.
.#....#.
.#....##
........
........
........
........
