........
........
.######.
.##.....
.##.....
.#####..
.....##.
......#.
......#.
......#.
.#...##.
..####..
........
........
........
........
