# PIECE ARTIFACT: 8x8x8 Voxel Bitmask
# Solid Reference Cube
z0=FF,FF,FF,FF,FF,FF,FF,FF
z1=FF,FF,FF,FF,FF,FF,FF,FF
z2=FF,FF,FF,FF,FF,FF,FF,FF
z3=FF,FF,FF,FF,FF,FF,FF,FF
z4=FF,FF,FF,FF,FF,FF,FF,FF
z5=FF,FF,FF,FF,FF,FF,FF,FF
z6=FF,FF,FF,FF,FF,FF,FF,FF
z7=FF,FF,FF,FF,FF,FF,FF,FF
