........
........
######..
...#....
...#....
...#....
...#....
...#....
...#....
...#....
...#....
######..
........
........
........
........
