........
........
...####.
..#...##
.#.....#
.#..####
#..#...#
#..#...#
#..#...#
#..#...#
.#..####
.#......
..#.....
...####.
........
........
