........
......#.
......#.
......#.
..###.#.
.##..##.
.#....#.
.#....#.
.#....#.
.#....#.
.##..##.
..###.#.
........
........
........
........
