........
........
........
........
.##...#.
..#..##.
...###..
...##...
...##...
..##.#..
..#..##.
.#....##
........
........
........
........
