........
........
..####..
.##...#.
.#......
.##.....
..###...
....###.
......#.
......#.
.#....#.
..####..
........
........
........
........
