........
........
..####..
.#...##.
......#.
.....##.
...###..
.....##.
......#.
......#.
.#...##.
..####..
........
........
........
........
