........
........
.#....##
..#...#.
..##.#..
...###..
...##...
...###..
..##.#..
..#..##.
.##...#.
##.....#
........
........
........
........
