........
........
......#.
.....##.
.....#..
.....#..
....#...
....#...
...#....
...#....
..##....
..#.....
.##.....
.#......
........
........
