+=========================================================+
| [Z-LEVEL]: 0                                               |
+=========================================================+
|  🧱🧱🧱🧱🧱🧱🧱🧱🧱🧱🧱🧱🧱🧱🧱🧱🧱🧱🧱🧱                                     |
|  🧱  ⬛⬛⬛⬛⬛⬛🐶⬛⬛🎯⬛⬛⬛⬛⬛🎯🧱                                     |
|  🧱  ⬛⬛⬛⬛⬛⬛⬛⬛⬛🧟⬛⬛⬛⬛⬛🎯🧱                                     |
|  🧱  ⬛⬛⬛⬛🪨⬛⬛⬛🐶⬛⬛⬛⬛⬛⬛🎯🧱                                     |
|  🧱  ⬛⬛⬛⬛🪨⬛⬛⬛⬛⬛⬛⬛⬛⬛⬛🎯🧱                                     |
|  🧱  ⬛⬛🎯⬛🪨⬛⬛⬛⬛⬛⬛🐶⬛⬛⬛🎯🧱                                     |
|  🧱  ⬛⬛⬛⬛🪨⬛⬛⬛⬛⬛⬛⬛⬛⬛⬛🎯🧱                                     |
|  🧱  ⬛⬛⬛⬛⬛⬛⬛⬛⬛⬛⬛⬛⬛⬛⬛⬛🧱                                     |
|  🧱                  🧱                                     |
|  🧱🧱🧱🧱🧱🧱🧱🧱🧱🧱🧱🧱🧱🧱🧱🧱🧱🧱🧱🧱                                     |
