........
........
........
........
..###.#.
..#..##.
.#....#.
.#....#.
.#....#.
.#....#.
..#..##.
..###.#.
......#.
......#.
......#.
........
