........
....#...
....#...
........
..###...
....#...
....#...
....#...
....#...
....#...
....#...
....#...
....#...
....#...
.###....
........
