........
...#....
...#....
........
.###....
...#....
...#....
...#....
...#....
...#....
...#....
######..
........
........
........
........
