........
........
........
........
....#...
....#...
....#...
.#######
....#...
....#...
....#...
........
........
........
........
........
