........
........
....##..
....##..
...#.#..
..#..#..
..#..#..
.#...#..
.#######
.....#..
.....#..
.....#..
........
........
........
........
