........
..###...
....#...
....#...
....#...
....#...
....#...
....#...
....#...
....#...
....#...
....#...
..###...
........
........
........
