........
........
........
........
.######.
.###....
.##.....
.##.....
.##.....
.##.....
.##.....
.##.....
........
........
........
........
