........
........
.######.
.#......
.#......
.#......
.#####..
.#......
.#......
.#......
.#......
.#......
........
........
........
........
