........
........
........
........
..####..
.##.....
.#......
##......
##......
.#......
.##.....
..####..
........
........
........
........
