........
........
........
........
........
........
........
.###...#
....###.
........
........
........
........
........
........
........
