........
........
...#....
...#....
.######.
...#....
...#....
...#....
...#....
...#....
...##...
....###.
........
........
........
........
