################
#..............#
#..............#
#.......>......#
#..............#
#..............#
#..............#
#..............#
#..............#
########<#######
