........
........
........
........
...###..
..#...#.
.#....#.
.#######
.#......
.#......
..#...#.
...###..
........
........
........
........
