........
........
########
....#...
....#...
....#...
....#...
....#...
....#...
....#...
....#...
....#...
........
........
........
........
