........
........
.#####..
.#...##.
.#....#.
.#....#.
.#...##.
.#####..
.#...#..
.#....#.
.#....##
.#.....#
........
........
........
........
