........
........
........
........
.......#
....###.
..###...
.##.....
..###...
....###.
.......#
........
........
........
........
........
