####################
#                  #
#                  #
#    .             #
#                  #
#   ###    R       #
#        .         #
#  #               #
#                  #
####################
