........
........
........
........
##...#..
##...#..
##...#..
##...#..
##...#..
##...#..
.#..##..
.###.#..
........
........
........
........
