........
........
........
........
#......#
##.....#
.#..#..#
.#.##.##
.#.#..#.
.###.##.
.##..##.
..#..##.
........
........
........
........
