........
........
...####.
.....##.
.....##.
.....##.
.....##.
.....##.
.....#..
.....#..
.#...#..
..###...
........
........
........
........
