........
...###..
...#....
..##....
######..
..##....
..##....
..##....
..##....
..##....
..##....
..##....
........
........
........
........
