........
........
...###..
..#.....
.##.....
.#......
.#......
.#...###
.#....##
.##...##
..#...##
...####.
........
........
........
........
