........
........
##......
##......
##......
##......
##......
##......
##......
##......
##......
#######.
........
........
........
........
