........
........
#####...
##...#..
##...##.
##...##.
##...#..
#####...
##......
##......
##......
##......
........
........
........
........
