........
........
#......#
##.....#
##.....#
.#.##..#
.#.##..#
.#.#..##
.#.#.##.
.##..##.
.##..##.
.##..##.
........
........
........
........
