........
........
.#....##
.##...#.
..#..##.
..##.#..
...###..
...##...
....#...
....#...
....#...
....#...
........
........
........
........
