........
........
.####...
#...##..
.....#..
.....#..
....##..
...##...
..##....
.##.....
.#......
######..
........
........
........
........
