........
........
..###...
.#..##..
.....#..
....##..
...##...
..##....
..##....
........
..##....
..##....
........
........
........
........
