........
..###...
..#.....
..#.....
..#.....
..#.....
..#.....
..#.....
..#.....
..#.....
..#.....
..#.....
..###...
........
........
........
