TTTTTTTTTTTTTTTTTTTTTTTTTTTTTTTTTTTTTTTT
T""""""""""""""""""""""""""""""""""""""T
T""""""""""""""""""""""""""""""""""""""T
T""""""""""""""""""""""""""""""""""""""T
T"""<:::::::::::::::"""""""""""""""""""T
T""""""""""""""""""""""""""""""""""""""T
T"""""""""T""""""""""""""""""""""""""""T
T""""""""""""""""""""""""""">""""""""""T
T""""""""""""""""""""""""~~~~~~""""""""T
T""""""""""""""""""""""""~~W~~~""""""""T
T""""""""""""""""""""""""~~~~~~""""""""T
T""""""""""""""T"""""""""""""""""""""""T
T""""""""""""""""""""""""""""""""""""""T
T""""""""""""""""""""""""""""""""""">""T
T""""""""""""""""""""""""""""""""""""""T
TTTTTTTTTTTTTTTTTTTTTTTTTTTTTTTTTTTTTTTT
