........
...#....
...#....
.####...
.#.#.#..
##.#....
.#.#....
..###...
...#.#..
...#.##.
#..#.#..
.####...
...#....
...#....
........
........
