....................
...###..............
.....#.........R....
.....#..........#...
....................
...............#....
....................
.........###........
....................
....................
