....................
..e..k..d...g.......
....T.....####R.....
..........#..#......
..........#..#T.....
.....R....#..#......
...........##.......
............T.......
....................
....................
