........
........
.##...##
.##..###
.##..###
.#.#.#.#
.#.##..#
.#..#..#
.#.....#
.#.....#
.#.....#
.#.....#
........
........
........
........
