........
...#....
...#....
....#...
....#...
....#...
....#...
....#...
....#...
....#...
....#...
...#....
...#....
........
........
........
