........
........
...#....
#..#.#..
..###...
..###...
#..#.#..
...#....
........
........
........
........
........
........
........
........
