####################
#                  #
#                  #
# TEMPLATE PROJECT #
#                  #
#       #          #
#     #  .  #      #
#     #            #
#                  #
####################
