........
........
.######.
......#.
.....##.
.....#..
....##..
....#...
....#...
...##...
...#....
..##....
........
........
........
........
