........
........
#....#..
#....#..
#....#..
#....#..
#....#..
#....#..
#....#..
#....#..
##...#..
.####...
........
........
........
........
