........
........
........
........
..####..
..#..##.
.#....#.
.#....#.
.#....#.
.#....#.
..#..##.
..####..
........
........
........
........
