####################
#..................#
#...T..........R...#
#....T.............#
#.........T........#
#....R.............#
#...........T......#
#..................#
#..................#
####################
