........
........
..##....
.#.#....
...#....
...#....
...#....
...#....
...#....
...#....
...#....
.#####..
........
........
........
........
