####################
#  UUUUUUUUUUUUUUUT#
#  U..............T#
#  U....RRR.......T#
#  U....RRR.......T#
#  U....RRR.......T#
#  U....RRR.......T#
#  U...............#
#  UUUUUUUUUUUUUUUU#
####################
