####################
#  SSSSSSSSSSSSSSST#
#  S..............T#
#  S....RRR.......T#
#  S....RRR.......T#
#  S....RRR.......T#
#  S....RRR.......T#
#  S...............#
#  SSSSSSSSSSSSSSSS#
####################
