####################
#..................#
#...T..........R...#
#..................#
#.........T........#
#....R.............#
#..................#
#...........T......#
#..................#
####################
