........
........
.####...
.#...##.
.#....#.
.#....#.
.#....##
.#....##
.#....#.
.#....#.
.#...##.
.####...
........
........
........
........
