........
........
..####..
..#.....
..#.....
..#.....
..##....
.#.##..#
##..##.#
.#...###
.##..##.
..####.#
........
........
........
........
