........
........
#######.
.....##.
....##..
....#...
...##...
..##....
..#.....
.##.....
##......
#######.
........
........
........
........
