........
........
...##.#.
...#..#.
...#..#.
.#######
..##.#..
..#..#..
########
..#.##..
.##.#...
.#..#...
........
........
........
........
