
--- FRAME at 2026-07-17 07:07:02 ---
+============================================================+
|                                                            |
|               M U C H I P A L - E D I T O R                |
|                                                            |
|P R O J E C T :   M u t a c l s y m   ( C D D A   c l o n e |
|                                                            |
|  [>] 1. [Browse Pieces]                                    |
|  [ ] 2. [Edit Map]                                         |
|                                                            |
+============================================================+
[0-9] jump  [enter] select  [q] quit


--- FRAME at 2026-07-17 07:07:07 ---
+============================================================+
|                                                            |
|               M U C H I P A L - E D I T O R                |
|                                                            |
[>] 1. [Open Project]
|                                                            |
+============================================================+

+=========================================================+
Nav > 1_


--- FRAME at 2026-07-17 07:07:07 ---
+============================================================+
|                                                            |
|               M U C H I P A L - E D I T O R                |
|                                                            |
|                      P R O J E C T S                       |
|                                                            |
|  [>] 1. [Mutaclsym (CDDA clone)]                           |
|  [ ] 2. [Piececraft 3D (voxel clone)]                      |
|                                                            |
+============================================================+
[0-9] jump  [enter] select  [q] quit


--- FRAME at 2026-07-17 07:07:22 ---
+============================================================+
|                                                            |
|               M U C H I P A L - E D I T O R                |
|                                                            |
|                      P R O J E C T S                       |
|                                                            |
|  [>] 1. [Mutaclsym (CDDA clone)]                           |
|  [ ] 2. [Piececraft 3D (voxel clone)]                      |
|                                                            |
+============================================================+
[0-9] jump  [enter] select  [q] quit


--- FRAME at 2026-07-17 07:07:22 ---
+============================================================+
|                                                            |
|               M U C H I P A L - E D I T O R                |
|                                                            |
|P R O J E C T :   M u t a c l s y m   ( C D D A   c l o n e |
|                                                            |
|  [>] 1. [Browse Pieces]                                    |
|  [ ] 2. [Edit Map]                                         |
|                                                            |
+============================================================+
[0-9] jump  [enter] select  [q] quit

