..#........#.#.#...#.###.
.#...#.##...#.#..........
.#A....#.#..##...#...#B#.
##...#.....#....##....##.
#....#..##.....##.......#
#.....#.#...##...##..#...
.#..#.#..#....##...##...#
..#...#.##........#.#....
#.#.#.....#.#...#.#....##
......#.#.....#....#.....
.................#...##..
.#..#.#.##.....#.#......#
.#.#.....##..#..#.#......
.#....#.###.#.#...#.#..#.
#......#.#.....##.##.....
#.#..#..#.#..#...#..#.##.
.#...#...............#.#.
..##........#.#...#..###.
....##...........#......#
....#..#.##.#.#....#.#...
...#..#........####.#...#
.#...##.....#.#.#...#....
#.C........#.#....#...D..
.##.#..#....#.##.#..#..##
##.#..##..#..#...##..#..#
