........
##......
##......
##......
#####...
##..##..
##...#..
##...#..
##...#..
##...#..
##...#..
##...#..
........
........
........
........
