........
........
.#....#.
.#....#.
.#....#.
.#....#.
.######.
.#....#.
.#....#.
.#....#.
.#....#.
.#....#.
........
........
........
........
