################
#..............#
#..............#
#.......<......#
#..............#
#..........Z...#
#..............#
#..........[...#
#..............#
################
