TTTTTTTTTTTTTTTTTTTTTTTTTTTTTTTTTTTTTTTTTTTTTTTTTTTTTTTTTTTTTTTTTTTTTTTTTTTTTTTT
T""""""""""""""""""""""""#######"""""""""""""""""""""""""""""""""""""""""""""""T
T"<""""""""""""""""""""""#.....#"""""""""""""""""""""""""""""""""""""""""""""""T
T""""""""""""""""""""""""#.....#""""""""""""""""""""""""""""""""""""""""~""""""T
T"""""""""""...................#"""""""""""""""""""""""""""""""""""""""~~~"""""T
T""""""""""".""""""""""""#.....#""""""""""""""""""""""""""""""""""""""""~""""""T
T""""""""""".""""""""""""###+###"""""""""""""""""""""""""""""""""""""""""""""""T
T""""""""""".""""""""""""""""""""""""""""""""""""""""""""""""""""""""""""""""""T
T""""""""""".""""""""""""""""""""""""""""""""""""""""""""""""""""""""""""""""""T
T""""""""""".""""""""""""""""""""""""""""""""""""""""""""""""""""""""""""""""""T
T""""""""""".""""""""""~"""""""""""""""""""""""""""""""""""""""""""""""""""""""T
T"""""""""""."""""""""~~~""""""""""""""""""""""""""""""""""""""########""""""""T
T""""""""""~.""""""""~~W~~"""""""""""""""""""""""""""""""""""""#......#""""""""T
T"""""""""~~."""""""""~~~"""""""""""""""""""""""""""""""""""..........#""""""""T
T""""""""""~.""""""""""~"""""""""""""""""""""""""""""""""""".""####.###""""""""T
T""""""""""".""""""""""""""""""""""""""""""""""""""""""""""".""""""."""""""""""T
T""""""""""".""""""""""""""""""""""""""""""""""""""""""""""".""""""."""""""""""T
T""""""""""".""""""""""""""""""""""""""""""""""""""""""""""".""""""."""""""""""T
T""""""""""".""""""""""""""""""""""""""""""""""""""""""""""".""""""."""""""""""T
T""""""""T""."""""""""""""""""""""""""""""""""""""""""""""##.##""""."""""""""""T
T"""""""TTT"."""""""""""""""""""""""""""""""""""""""""""""#...#""""."""""""""""T
T""""""""T""."""""""""""""""""""""""""""""""""""""""""""""#...#""""."""""""""""T
T""""""""""".""""""""""""""""""""""""""""""""""""""...........#""""."""""""""""T
T"""""""""""."""""""""""""""""""""""""""""""""""""".""""""#...#""""."""""""""""T
T"""""""""""."""""""""""""""""""""""""""""""""""""".""""""##+##""""."""""""""""T
T""""""""""".""""""""""""""""""""""""""""""""""""""."""""""""""""""."""""""""""T
T""""""""""".""""""""""""""""""""""""""""""""""""""."""""""""""""""."""""""""""T
T""""""""""".""""""""""""""""""""""""""""""""""""""."""""""""""""""."""""""""""T
T""""""""""".""""""""""""""""""""""""""""""""""""""."""""""""""""""."""""""""""T
T""""""""""".""""""""""""""""""""""""""""""""""""""."""""""""""""""."""""""""""T
T""""""""""".""""""""""""""""""""""""""""""""""""""."""""""""""""""."""""""""""T
T""""""""###.###"""""""""""""""""""""""""""""""####.####"""""""""""."""""""""""T
T""""""""#.....#"""""""""""""""""""""""""""""""#.......#"""""""""""."""""""""""T
T""""""""#.....................................#.......#............"""""""""""T
T""""""""#.....#"""""""""""""""""""""""""""""""#.......#"""""""""""""""""""""""T
T""""""""###+###"""""""""""""""""""""""""""""""#.......#"""""""""""""""""""""""T
T""""""""""""""""""""""""""""""""""""""""""""""####+####"""""""""""""""""""""""T
T""""""""""""""""""""""""""""""""""""""""""""""""""""""""""""""""""""""""""""""T
T""""""""""""""""""""""""""""""""""""""""""""""""""""""""""""""""""""""""""""""T
TTTTTTTTTTTTTTTTTTTTTTTTTTTTTTTTTTTTTTTTTTTTTTTTTTTTTTTTTTTTTTTTTTTTTTTTTTTTTTTT
