........
........
..####..
.##..##.
.#....#.
.#....#.
.##..##.
..###.#.
......#.
......#.
.....##.
..####..
........
........
........
........
